120 100 10 200 100 900 10
0
0
0
0
0
41 10
2000000000000000000000000000000000000003
2000000000000000000000000000000000000003
2000000000000000000000000000000000000003
2000000000000000000000000000000022222003
20000000000000000000000000000000000#0003
2ааа000000000000000000000000000222222003
2222000000000000000000000000000000000003
2000000000000000000000000000000000000003
2000000000000000000000000000000000000003
2000000000000000000000000000000000000003

