150 1 25 0 0 0
0
0
0
0
0
23 13
33333333333333333333333
30AA0000000000000000003
32222222000000000000003
3000000030AA03000000003
30000000322230030000003
30000000000003000000003
30000000000000030000003
30000000000#00000300003
30000000013330000003003
30000000100003000000033
3000000100000030A033333
30AAA010000000033333333
33333330000000033333333