100 100 10 200 100 900 10
150 100 15 200 100 900 10
0
0
0
0
70 12
3000000000000000000000000000000000000000000003000000000000000000000003
3000000000000000000000000000000000000000000003000000000000000000000003
3000000000000000000000000000000000000000000003000000000000000000000003
3000000660060000000000000000000000000000000003000000000000000000000003
3000000000006003300800800000000000000000000003000000000000000000000003
3000110000000000000000000306000000000000000003000000000000000000000003
3000000600000000000000000000000R000010B099A303000000000000000000000003
3000000000000000000000000001113333333333333303*00000000000000000000003
3000000030000000000000000000000000000000000303336000000000000000000003
300#006000000000000000000000000000000000000300000013737373060000000333
30333000000000000000000000000000000000000003222311100000000003000009@3
3000000000000000000000000000000000000000000000000000000000000333333333