200 50 5 200 100 900 10
200 50 5 200 100 900 10
0
0
0
0
100 17
0000000000000000000000000000000000000000000000000000000000000000000000000000000000000000000000000000
0000000000000000000000000000000000000000000000000000000000000000000000000000000000000000003000000000
0000000000000000000000000000000000000000000000000000000000000000000000000000000000000000003000000000
00000000000000000000R0066003000000000000000000000000000000000000000000000000000006022200803000000000
0000000000000000000030000000300000000000000000000000000000000000000000000000000000000000303000000000
0000000000000000000003000000033733000000000000000000000000000000000000000000000030000000303000000000
0000000000000000000000300000000003003000000000000000000000000000000000000000000006000000303000000300
0000000000000000000000066660000003000300000000000000000000000000000000000000000000R00000300000000300
00000000000000000000000000000L09a30000300000000000000000000000000000000000000000003000R0300000000300
0000000000000000000000000003333323000003000000000000000000000000000000003333308003033330322333000333
30000000000000R00000303003000000000000003000000000000000000000000000033330000000000300B*000300060003
300000000000003080300000000000000000000003000000000000000000000000333300000000000309aA0A0A0300600603
3000000111111000000000000000000000000000000300000000000000000000033333000000000003333333333300006003
30000013000000000000000000000000000000000000030000000000000000003333A3333000000000000000000000600003
3000013000000000300000300000300000000000000000030000000000000003333303300036000000000000000000060333
30#0130000000000003330003330000R000000000000000003000000000030999999999003a00R000000000000000000a9@3
3333300000000000000000000000003337770777077707773330033300333333222222223333333778787787333333333333