120 100 10 200 100 900 10
0
0
0
0
0
70 12
0000000000000000000000000000000000000000000000000000000000000000000000
2000000000000000000000000000000000000000000000000000000000000020000000
2000000000000000000000000000000000000000000000000000000000000020000000
2200002200000000000000000000000000000000000000000000000000000020000000
22000009a9000000000000000000000000a00000000606002227722200000020000000
2202222220222726000000000000000022222000220000000000000000200020000000
220200000000000000000000000000000L#R0022000000000000000000002020222000
2a090000000000002000000000000002222222000000000000000000000020222A2222
22222200000000000600606000000200000000000000000000000000000*20009990@2
0000000600000000000000002202000000000000000000600600277727772222222222
00000000060000@R000000000000606060006000000060000000000000000000000000
0000000000022222006006006676660000060006006000000000000000000000000000

