100 1 25 0 0 0
0
0
0
0
0
23 12
33333333333333333333333
30000000000000000000003
30000000000000000000003
30033333333322222330003
33000000000000000000003
33330000000000000000003
300030A0000#00A03000003
30000333333333333333333
30000000000003003000003
30000000000003303000003
300000000000030330000@3
03330010088003300388113
