350 100 5 200 100 900
0
0
0
0
0
23 13
33333333333333333333333
30AA0000000000000000003
32222222000000000000003
3000000030AA30000000003
30000000322230030000003
30000000000003000000003
30000000000000030000003
30000000000000000300003
300000000133a0000003003
30000000110033300000933
300666011000003aa#33333
30300000000000033333333
33333330000000033333333