120 100 10 200 100 900 10
0
0
0
0
0
70 10
2000000000000000000000000000000000000000000000000000000000000000000003
2200002220000000000000000000000000000000000000000000000000000000000003
22000009а9000000000000000000000000000000000000000000000000000000000003
2202222220222726000000000000000022222000000000000000000000000000000003
2202000000000000000000000000000000#00000000000000000000000000000000003
2а00000000000000200000000000000222222000000000000000000000000000000003
2222220000000000060060600000020000000000000000000000000000000000000003
3000000600000000000000002202000000000000000000000000000000000000000003
30000000060000@0000000000000000000000000000000000000000000000000000003
3000000000022222000000000000000000000000000000000000000000000000000003

