120 100 10 200 100 900 10
0
0
0
0
0
70 15
3000000000000000000000000000000000000000000000000000000000000000000003
3000000000000000000000000000000000000000000000000000000000000000000003
3000000000000000000000000000000000000000000000000000000000000000000003
3000000000000000000000000000000000000000000000000000000000000000000003
3000000000000000000000000000000000000000000000000000000000000000000003
3000000000000000000000000000000000000000000000000000000000000000000003
3000000000000000000000000000000000000000000000000000000000000000000003
3000000000000000000000000000000000000000000000000000000000000000000003
3000000000000000000000000000000000000000000000000000000000000000000003
3000000000000000000000000000000000000000000000000000000000000000000003
30000000R0000000*06060000000000000000000000000000000000000000000000003
3000000110010010300003301101110000000000000000000000000000000000000003
3000001330000000000000000003331000000000000000000000000000000000003333
10#001333000000000000000000333310000000000000000009A1111000000000009@3
1111133330000000000000000003333311113311222221133333333303333333333333