120 100 10 200 100 900 10
200 10 20 200 100 900 25
0
0
0
0
70 12
0000000000000000000000000000008000000000000000000000000000000000000000
0000000000000000000000000000008000000000000000000000000000000000000000
0000000000000000000000000000008000000000000000000000000000000000000000
8000000000000000000000000000008000000000000000000000000000000000000008
8000000000000000000R00000000098000000000000000000000000000000000000008
80000000000000000888888778888*8000000000000000000000000000000000000008
8000000000000006000000000000808000000000000000000000000000000000008888
80000000000000000000000000008080000000000000000088808080060680000B09@8
8000000000000000800000000000800000000000600600600000000000008888888888
8000000000000006000000000000800000A00A08000000000000000000000000000008
800#008808878800000000000000888888888888000000000000000000000000000008
8033300000000000000000000000000000000000000000000000000000000000000000
