30 100 25 200 100 900 10
150 100 25 200 100 900 10
150 100 25 200 100 900 10
0
0
0
23 13
33333333333333333333333
3@00000c000000000000003
32222222000000000000003
3000000030C0300#0000003
30000000322230033337333
30000000000003000000003
30000000000000030000003
30000000000000000300003
30000000013300000003003
30000000110033300000933
30066601100000300033333
30300000000000033333333
33333330000000033333333