30 100 25 200 100 900 10
0
0
0
0
0
23 13
33333333333333333333333
3@AA0000000000000000003
32222222000000000000003
3000000030AA300#0000003
30000000322230033337333
30000000000003000000003
30000000000000030000003
30000000000000000300003
300000000133a0000003003
30000000110033300000933
300666011000003aa033333
30300000000000033333333
33333330000000033333333