120 100 10 200 100 900 10
150 100 15 200 100 900 10
0
0
0
0
70 10
0000000000000000000000000000000000000000000000000000000000000000000000
0000000000000000000000000000000000000001111100000000000000000000000000
000000000000000000000000000000000000000990A100000000000000000000000001
0000000000000000000000000000000061100111111100000000000000000000000001
0000000000000000000000000000001000060001111000000000000000000000000001
10000000000000000000000000006000000060000А900R0000000000000000010ABA*1
1000000000R00000000060600110000000000661161111006606600000061111111111
10000000011771122110000000000000000000000000000000000001100009@1000000
10#0060600000000000000000000000000000000000000000000000000111111000000
1111000000000000000000000000000000000000000000000000000000000000000000