0
0
0
0
0
0
25 10
3333333333333333333333333
3000000000000000000000003
3000000000000000000000003
3000000000000000000000003
3000000000000000000000003
3000000000000000000000003
3000000000000000000000003
3000000000000000000000003
300#000000000000000000003
3111118888881112221111113