0
0
0
0
0
0
23 11
30000000000000000000003
30033333333322222330003
33000000000000000000003
30300000000000000000003
30030000000000000000003
30003000000#00000000003
30000333333333330000003
30000000000000000000003
30000000000000000000003
300000000000000000000@3
0333001008800330038813
