150 100 5 200 100 900 10
0
0
0
0
0
100 21
0000000030000000000000000000000000300000000000000000000000000000000000000030003000000000000000000003
0000000033333333333333333333333333300000000000000000000000000000000000000030003000000000000000000003
0000000033090000000090000000999000000000000000000000000000000000000000000030003000000000000000000003
33333333333333333333306033333333333330A0090000000900000000000000000000000033333000000000000000000003
30000000000000000003000030000000000033333333333333333333300330033003306000333330333330030030030#0303
3000000000000000003000030000000000003300000000000000000330033003300330060033333033300000000003333303
3000000000000000030000300000000000003300000000000000000330000000000000006000009090300000000003000303
3000000000000000300003000000000000003300000000003333333330000000000000000333333333300000000003000303
3000000000000003000030000000000000003300000000003000000000000000000000000300000000300000000003000333
3000000000000030000300000000000000003300000000003000000000000000000000000300000000300000000003000003
3000000000000300003000000000000000003300000000003000000000000000000000000300000000300000000003000003
3000000000003000030000000000000000003333333333333333333333333333333333333300000000333333333333333333
3000000000030000300000000000000000000330000000000000000000000000000000000000000000000000000000000000
3000000000300003000000000000006660000330000000000000000000000000000000000000000000000000000000000000
3000000003000030000000000000000000000333333333333333333333333333333333333333333333333333333333333333
3000000030000300000000000000000000333333333330000000000000000000000000000000000000000000000000000003
3000000300003000000000000000003330000000000000000000000000000000000000000000000000000000000000000003
3000003000030000000000006333000000000000000000000000000000000000000600000060000000606660000000000333
3000030000600000003333000000000000000000000000000000000000000600600000600000066600000000066000003333
3000030000000000033003300000000000000000000033000000000000060000000000000606000000600000000006000903
3333333333333333330000333333333333333300330033003300333333000000000000000000000000000600666663333333