0
0
0
0
0
0
25 10
3333333333333333333333333
3000000000000000000000003
3000000000000000000000003
3000000000000000000000003
3000000000000033333333303
3000000000000300000000033
3030000000033000000000003
3300000033300000000000003
3000#00330030000000000003
3333333333333333333333333