150 100 9 200 100 900 10
0
0
0
0
0
100 21
0000000000000000000000000000000000300000000000000000000000000000000000000000000000000000000000000000
0000000033333333333333333333333333300000000000000000000000000000000000000030003000000000000000000000
0000000033a9R000000090000000999000L00000000000000000000000000000000000000030003000000000000000000003
00000000333333333333306033333333333330A00900aa00099900000000000000000000003000300000000000000L000L03
00000000000000000003000030000000000033333333333333333333300330088003306000300030333330030030030#0303
0000000000000000003000030000000000003000000000000000000330033003300330060033333033300000000003333303
000000000000000003000030000000000000300000000000000000033000000000000000600000909a300000000003000303
0000000000000000300003000000000000003000000000003333333330000000000000000333333333300000000003000303
0000000000000003000030000000000000003000000000003000000000000000000000000300000000300000000003000373
0000000000000030000300000000000000003000000000003000000000000000000000000300000000300000000003000000
0000000000000300003000000000000000003000000000003000000000000000000000000300000000300000000003000000
0000000000003000030000000000000000003333333333333777777777777777777777777300000000377777777773000000
0000000000030000300000000000000*00000300000000000000000000000000000000000000000000000000000000000000
0000000000300003000000000000006660000300000000000000000000000000000000000000000000000000000000000000
00000000030000300000000000000000000L0300000000000000000000000000000000000000000000000000000000000003
0000000030000300000000000000000R00333300000000000000000000000000000000000000000000000000000000000003
00000003000030000000000000R00033300000000000000000000000000000000000000000000000000000000000000000a3
00000030000300000000R0006333000000000000000000000000000000000000000600000060000000606660000000000333
0000030000600000001111000000000000000000000000000000000000000600600000600000066600000000066000003333
0000030000000000013003100000000000R000000000330000000000000600000000000006060000006000000000060009@3
0000032222333333330000333333333333333300330033008800333333000000000000000000000000000600666663333333