350 100 5 200 100 900 10
0
0
0
0
0
100 20
3333333333333333333333333333333333333333333333333333333333333333333333333333333333333333333333333333
3000000000000000000000000000000000000000000000000000000000000000000000000000000000000000000000000033
3000000000000000000000000000000000000000000000000000000000000000000000000000000000000000000000000033
3000000000000000000000000000000000000000000000000000000000000000000000000000000000000000000000000033
3000000000000000000000000000000000000000000000000000000000000000000000000000000000000000000000000033
3000000000000000000000000000000000000000000000000000000000000000000000000000000000000000000000000033
3000000000000000000000066003000000000000000000000000000000000000000000000000000000000000000000000033
3000000000000000000030000000300000000000000000000000000000000000000000000000000000000000000000000033
3000000000000000000003000000033333000000000000000000000000000000000000000000000000000000000000000333
3000000000000000000000300000000003003000000000000000000000000000000000000000000000000000000000000333
3000000000000000000000066660000003000300000000000000000000000000000000000000000000000000000000000333
3000000000000000000000000000000A03000030000000000000000000000000000000000000000000300000300000000333
3000000000000000000000000003333333000003000000000000000000000000000000003333303003033330333333000333
300000000000000000003030030000000000000030000000000000000000000000000333333000000003A0A0A00300060003
300000000000003030300000000000000000000003000000000000000000000000333333330000000309aA0A0A0300600603
3000000333333000000000000000000000000000000300000000000000000000033333333000000003333333333300006003
30000033333330000000000000000000000000000000030000000000000000003333A3333000000000000000000000600003
3000033333333000300000300000300000000000000000030000000000000003333303300030000000000000000000060333
30#033333333300000333000333000000000000000000000030000000000309999999999930000000000000000000000a9@3
3333333333333000000000000000003333333333333333333330033300333333333333333333333333333333333333333333